611111111j111111113
200000000c000000002
20a80ab8090ab80a802
2000000000000000002
20a8070abdb8070a802
20000c000c000c00002
51130gb8090abe06114
00020c0000000c02000
111409061h130905111
0000000200020000000
1113070511140706111
00020c0000000c02000
6114090abdb80905113
200000000c000000002
20am0ab8090ab80n802
200c00000i00000c002
l809070abdb807090ak
20000c000c000c00002
20abbfb8090abfbb802
2000000000000000002
5111111111111111114
