{
  "map" : [
    ["6", "1", "1", "1", "1", "1", "1", "1", "1", "j", "1", "1", "1", "1", "1", "1", "1", "1", "3"],
    ["2", "0", "0", "0", "0", "0", "0", "0", "0", "c", "0", "0", "0", "0", "0", "0", "0", "0", "2"],
    ["2", "0", "a", "8", "0", "a", "b", "8", "0", "9", "0", "a", "b", "8", "0", "a", "8", "0", "2"],
    ["2", "0", "0", "0", "0", "0", "0", "0", "0", "0", "0", "0", "0", "0", "0", "0", "0", "0", "2"],
    ["2", "0", "a", "8", "0", "7", "0", "a", "b", "d", "b", "8", "0", "7", "0", "a", "8", "0", "2"],
    ["2", "0", "0", "0", "0", "c", "0", "0", "0", "c", "0", "0", "0", "c", "0", "0", "0", "0", "2"],
    ["5", "1", "1", "3", "0", "g", "b", "8", "0", "9", "0", "a", "b", "e", "0", "6", "1", "1", "4"],
    ["0", "0", "0", "2", "0", "c", "0", "0", "0", "0", "0", "0", "0", "c", "0", "2", "0", "0", "0"],
    ["1", "1", "1", "4", "0", "9", "0", "6", "1", "h", "1", "3", "0", "9", "0", "5", "1", "1", "1"],
    ["0", "0", "0", "0", "0", "0", "0", "2", "0", "0", "0", "2", "0", "0", "0", "0", "0", "0", "0"],
    ["1", "1", "1", "3", "0", "7", "0", "5", "1", "1", "1", "4", "0", "7", "0", "6", "1", "1", "1"],
    ["0", "0", "0", "2", "0", "c", "0", "0", "0", "0", "0", "0", "0", "c", "0", "2", "0", "0", "0"],
    ["6", "1", "1", "4", "0", "9", "0", "a", "b", "d", "b", "8", "0", "9", "0", "5", "1", "1", "3"],
    ["2", "0", "0", "0", "0", "0", "0", "0", "0", "c", "0", "0", "0", "0", "0", "0", "0", "0", "2"],
    ["2", "0", "a", "m", "0", "a", "b", "8", "0", "9", "0", "a", "b", "8", "0", "n", "8", "0", "2"],
    ["2", "0", "0", "c", "0", "0", "0", "0", "0", "i", "0", "0", "0", "0", "0", "c", "0", "0", "2"],
    ["l", "8", "0", "9", "0", "7", "0", "a", "b", "d", "b", "8", "0", "7", "0", "9", "0", "a", "k"],
    ["2", "0", "0", "0", "0", "c", "0", "0", "0", "c", "0", "0", "0", "c", "0", "0", "0", "0", "2"],
    ["2", "0", "a", "b", "b", "f", "b", "8", "0", "9", "0", "a", "b", "f", "b", "b", "8", "0", "2"],
    ["2", "0", "0", "0", "0", "0", "0", "0", "0", "0", "0", "0", "0", "0", "0", "0", "0", "0", "2"],
    ["5", "1", "1", "1", "1", "1", "1", "1", "1", "1", "1", "1", "1", "1", "1", "1", "1", "1", "4"]
  ],
  "points" : [
    ["0", "0", "0", "0", "0", "0", "0", "0", "0", "0", "0", "0", "0", "0", "0", "0", "0", "0", "0"],
    ["0", "1", "1", "1", "1", "1", "1", "1", "1", "0", "1", "1", "1", "1", "1", "1", "1", "1", "0"],
    ["0", "2", "0", "0", "1", "0", "0", "0", "1", "0", "1", "0", "0", "0", "1", "0", "0", "2", "0"],
    ["0", "1", "1", "1", "1", "1", "1", "1", "1", "1", "1", "1", "1", "1", "1", "1", "1", "1", "0"],
    ["0", "1", "0", "0", "1", "0", "1", "0", "0", "0", "0", "0", "1", "0", "1", "0", "0", "1", "0"],
    ["0", "1", "1", "1", "1", "0", "1", "1", "1", "0", "1", "1", "1", "0", "1", "1", "1", "1", "0"],
    ["0", "0", "0", "0", "1", "0", "0", "0", "1", "0", "1", "0", "0", "0", "1", "0", "0", "0", "0"],
    ["0", "0", "0", "0", "1", "0", "0", "0", "0", "0", "0", "0", "0", "0", "1", "0", "0", "0", "0"],
    ["0", "0", "0", "0", "1", "0", "0", "0", "0", "0", "0", "0", "0", "0", "1", "0", "0", "0", "0"],
    ["0", "0", "0", "0", "1", "0", "0", "0", "0", "0", "0", "0", "0", "0", "1", "0", "0", "0", "0"],
    ["0", "0", "0", "0", "1", "0", "0", "0", "0", "0", "0", "0", "0", "0", "1", "0", "0", "0", "0"],
    ["0", "0", "0", "0", "1", "0", "0", "0", "0", "0", "0", "0", "0", "0", "1", "0", "0", "0", "0"],
    ["0", "0", "0", "0", "1", "0", "0", "0", "0", "0", "0", "0", "0", "0", "1", "0", "0", "0", "0"],
    ["0", "1", "1", "1", "1", "1", "1", "1", "1", "0", "1", "1", "1", "1", "1", "1", "1", "1", "0"],
    ["0", "1", "0", "0", "1", "0", "0", "0", "1", "0", "1", "0", "0", "0", "1", "0", "0", "1", "0"],
    ["0", "2", "1", "0", "1", "1", "1", "1", "1", "0", "1", "1", "1", "1", "1", "0", "1", "2", "0"],
    ["0", "0", "1", "0", "1", "0", "1", "0", "0", "0", "0", "0", "1", "0", "1", "0", "1", "0", "0"],
    ["0", "1", "1", "1", "1", "0", "1", "1", "1", "0", "1", "1", "1", "0", "1", "1", "1", "1", "0"],
    ["0", "1", "0", "0", "0", "0", "0", "0", "1", "0", "1", "0", "0", "0", "0", "0", "0", "1", "0"],
    ["0", "1", "1", "1", "1", "1", "1", "1", "1", "1", "1", "1", "1", "1", "1", "1", "1", "1", "0"],
    ["0", "0", "0", "0", "0", "0", "0", "0", "0", "0", "0", "0", "0", "0", "0", "0", "0", "0", "0"]
  ],
  "boosts" : [
    ["0", "0", "0", "0", "0", "0", "0", "0", "0", "0", "0", "0", "0", "0", "0", "0", "0", "0", "0"],
    ["0", "1", "1", "1", "1", "1", "1", "1", "1", "0", "1", "1", "1", "1", "1", "1", "1", "1", "0"],
    ["0", "2", "0", "0", "1", "0", "0", "0", "1", "0", "1", "0", "0", "0", "1", "0", "0", "2", "0"],
    ["0", "1", "1", "1", "1", "1", "1", "1", "1", "1", "1", "1", "1", "1", "1", "1", "1", "1", "0"],
    ["0", "1", "0", "0", "1", "0", "1", "0", "0", "0", "0", "0", "1", "0", "1", "0", "0", "1", "0"],
    ["0", "1", "1", "1", "1", "0", "1", "1", "1", "0", "1", "1", "1", "0", "1", "1", "1", "1", "0"],
    ["0", "0", "0", "0", "1", "0", "0", "0", "1", "0", "1", "0", "0", "0", "1", "0", "0", "0", "0"],
    ["0", "0", "0", "0", "1", "0", "0", "0", "0", "0", "0", "0", "0", "0", "1", "0", "0", "0", "0"],
    ["0", "0", "0", "0", "1", "0", "0", "0", "0", "0", "0", "0", "0", "0", "1", "0", "0", "0", "0"],
    ["0", "0", "0", "0", "1", "0", "0", "0", "0", "0", "0", "0", "0", "0", "1", "0", "0", "0", "0"],
    ["0", "0", "0", "0", "1", "0", "0", "0", "0", "0", "0", "0", "0", "0", "1", "0", "0", "0", "0"],
    ["0", "0", "0", "0", "1", "0", "0", "0", "0", "0", "0", "0", "0", "0", "1", "0", "0", "0", "0"],
    ["0", "0", "0", "0", "1", "0", "0", "0", "0", "0", "0", "0", "0", "0", "1", "0", "0", "0", "0"],
    ["0", "1", "1", "1", "1", "1", "1", "1", "1", "0", "1", "1", "1", "1", "1", "1", "1", "1", "0"],
    ["0", "1", "0", "0", "1", "0", "0", "0", "1", "0", "1", "0", "0", "0", "1", "0", "0", "1", "0"],
    ["0", "2", "1", "0", "1", "1", "1", "1", "1", "0", "1", "1", "1", "1", "1", "0", "1", "2", "0"],
    ["0", "0", "1", "0", "1", "0", "1", "0", "0", "0", "0", "0", "1", "0", "1", "0", "1", "0", "0"],
    ["0", "1", "1", "1", "1", "0", "1", "1", "1", "0", "1", "1", "1", "0", "1", "1", "1", "1", "0"],
    ["0", "1", "0", "0", "0", "0", "0", "0", "1", "0", "1", "0", "0", "0", "0", "0", "0", "1", "0"],
    ["0", "1", "1", "1", "1", "1", "1", "1", "1", "1", "1", "1", "1", "1", "1", "1", "1", "1", "0"],
    ["0", "0", "0", "0", "0", "0", "0", "0", "0", "0", "0", "0", "0", "0", "0", "0", "0", "0", "0"]
  ],
  "ghost_house" : {
    "tiles" : [[8, 9], [9, 9], [10, 9]],
    "entrance" : [9, 8],
    "ghost_house_exit_target" : [9, 7],
    "ghost_house_exit_direction" : [-1, 0]
  },
  "no_move_up_tiles" : [],
  "exit_time" : [],
  "chase_duration": {
    "1" : [20000, 20000, 20000, 20000, null],
    "2" : [20000, 20000, 20000, 20000, null]
  },
  "scatter_duration": {
    "1" : [7000, 7000, 5000, 5000, null],
    "2" : [7000, 7000, 5000, 5000, null]
  },
  "player_spawn": [0, 0],
  "ghost_exit_timeout" : [
    1000,
    1500,
    2000
  ]
}