0000000000000000000
0111111110111111110
0200100010100010020
0111111111111111110
0100101000001010010
0111101110111011110
0000100010100010000
0000100000000010000
0000100000000010000
0000100000000010000
0000100000000010000
0000100000000010000
0000100000000010000
0111111110111111110
0100100010100010010
0210111110111110120
0010101000001010100
0111101110111011110
0100000010100000010
0111111111111111110
0000000000000000000

